1;0;0;0;0;0;1;1;1;1;1;1;5;0;0;0;0;m;e;0;0;0;0;0;0;0;0;0;0;1
1;0;0;0;0;0;6;6;6;6;6;6;4;0;0;0;0;2;2;5;3;0;0;0;0;0;0;0;0;1
1;0;0;0;0;0;0;0;0;0;0;0;4;0;0;0;0;0;0;4;0;0;0;0;0;0;0;0;0;1
1;3;2;2;2;1;0;0;s;0;0;0;4;0;0;0;0;0;0;4;0;0;0;0;0;0;0;0;0;1
1;3;3;3;3;2;3;2;2;2;5;2;2;2;2;2;2;2;2;2;2;5;0;0;0;0;0;0;0;1
1;3;0;m;0;2;0;0;0;0;4;0;0;0;0;a;0;0;0;0;0;4;0;0;m;0;e;0;0;1
1;2;2;2;2;2;0;0;0;0;4;0;m;0;0;0;0;0;0;0;0;4;2;2;2;2;2;2;2;1
1;0;0;0;0;0;0;2;2;2;2;2;2;5;2;2;2;2;2;5;2;2;3;3;3;3;3;3;3;1
1;0;0;0;0;0;0;0;0;0;0;2;0;4;0;0;0;0;0;4;0;0;1;1;0;0;0;0;0;1
1;2;2;2;2;5;2;2;2;2;5;2;0;4;0;0;0;0;0;4;0;0;0;0;1;1;0;0;m;1
1;0;0;0;0;4;0;0;0;0;4;2;2;2;2;2;2;2;5;2;0;0;0;0;0;0;3;2;2;1
1;0;0;0;0;4;0;0;0;0;4;0;0;0;0;0;0;0;4;0;0;0;0;0;0;0;0;0;0;1
1;e;0;0;0;4;0;0;0;0;4;0;0;0;0;0;0;0;4;0;0;0;0;0;0;e;0;0;0;1
1;2;2;2;5;2;2;2;2;2;2;2;2;2;2;0;0;0;4;m;0;0;2;2;2;2;2;5;0;1
1;0;0;0;4;0;0;0;0;0;0;0;0;0;0;0;5;2;2;2;5;0;0;0;0;0;0;4;0;1
1;m;0;0;4;0;0;0;0;0;0;0;0;0;0;p;4;2;2;2;4;0;0;0;0;0;0;4;m;1
1;2;2;2;2;2;2;2;2;2;2;2;2;2;2;2;2;2;2;2;2;2;2;2;2;2;2;2;2;1
1;1;1;1;1;1;1;1;1;1;1;1;1;1;1;1;1;1;1;1;1;1;1;1;1;1;1;1;1;1